{
  "id": "exit_wing",
  "name": "Exit Wing",
  "width": 48,
  "height": 24,
  "background": "#221218",
  "tiles": [
    "################################################",
    "#..............................................#",
    "#..............................................#",
    "#..............................................#",
    "#..............................................#",
    "#..............................................#",
    "#..............................................#",
    "#..............................................#",
    "#..............................................#",
    "#..............................................#",
    "#..............................................#",
    "#..............................................#",
    "#..............................................#",
    "#..............................................#",
    "#..............................................#",
    "#..............................................#",
    "#...........................======.............#",
    "#..............................................#",
    "#..............................................#",
    "#..............................................#",
    "#.................GGGGGG.^^....................#",
    "##########....##################################",
    "##########^^^^##################################",
    "################################################"
  ],
  "entities": [
    {
      "type": "spawn",
      "x": 2,
      "y": 20
    },
    {
      "type": "checkpoint",
      "x": 4,
      "y": 20
    },
    {
      "type": "pickup",
      "item": "scrap_metal",
      "x": 7,
      "y": 20
    },
    {
      "type": "pickup",
      "item": "goo_blob",
      "x": 20,
      "y": 19
    },
    {
      "type": "enemy",
      "enemy": "spotter",
      "x": 31,
      "y": 20
    },
    {
      "type": "enemy",
      "enemy": "crawler",
      "x": 38,
      "y": 20,
      "patrolMinX": 36,
      "patrolMaxX": 43
    },
    {
      "type": "exit",
      "x": 44,
      "y": 18
    }
  ]
}
