{
  "id": "mess_hall",
  "name": "Mess Hall",
  "width": 52,
  "height": 24,
  "background": "#1c1712",
  "tiles": [
    "####################################################",
    "#..................................................#",
    "#..................................................#",
    "#..................................................#",
    "#..................................................#",
    "#..................................................#",
    "#..................................................#",
    "#..................................................#",
    "#..................................................#",
    "#..................................................#",
    "#..................................................#",
    "#..................................................#",
    "#..................................................#",
    "#..................................................#",
    "#..................................................#",
    "#..................................................#",
    "#..................................................#",
    "#......................................======......#",
    "#.......====....====....====.......................#",
    "#..................................................#",
    "#.......................................^^^^.......#",
    "####################################################",
    "####################################################",
    "####################################################"
  ],
  "entities": [
    {
      "type": "spawn",
      "x": 2,
      "y": 20
    },
    {
      "type": "checkpoint",
      "x": 4,
      "y": 20
    },
    {
      "type": "pickup",
      "item": "glow_mushroom",
      "x": 6,
      "y": 20
    },
    {
      "type": "hint",
      "x": 30,
      "y": 15,
      "text": "Q — cycle items · F — use"
    },
    {
      "type": "pickup",
      "item": "plank",
      "x": 9,
      "y": 17
    },
    {
      "type": "enemy",
      "enemy": "crawler",
      "x": 14,
      "y": 20,
      "patrolMinX": 12,
      "patrolMaxX": 26
    },
    {
      "type": "note",
      "x": 17,
      "y": 17,
      "recipe": "recipe_sticky_trap",
      "text": "Goo on a plank stops the walkers dead. They just... stand there. It's very funny. — Subject #28"
    },
    {
      "type": "pickup",
      "item": "goo_blob",
      "x": 25,
      "y": 17
    },
    {
      "type": "locker",
      "x": 31,
      "y": 20
    },
    {
      "type": "enemy",
      "enemy": "spotter",
      "x": 36,
      "y": 20
    },
    {
      "type": "pickup",
      "item": "goo_blob",
      "x": 47,
      "y": 20
    },
    {
      "type": "pickup",
      "item": "plank",
      "x": 49,
      "y": 20
    },
    {
      "type": "door",
      "x": 50,
      "y": 20,
      "to": "next"
    }
  ]
}
