{
  "id": "mess_hall",
  "name": "Boiler Room",
  "width": 56,
  "height": 56,
  "background": "#1c1712",
  "tiles": [
    "########################################################",
    "########################################################",
    "########################################################",
    "##################.....................................#",
    "##################.....................................#",
    "##################.........###.........................#",
    "##################..........J..........................#",
    "##################..........J..........................#",
    "########.....#####.....####LLL############CCCCCCC#######",
    "########.....#####........CCCCC........................#",
    "########.....#####===..................................#",
    "########.........#.........................=====.......#",
    "########.........#.....====..====......M.........M.....#",
    "########.M.......#.....................M.........M.....#",
    "########.M.......#########MMMMM#########################",
    "########.M.............................#...............#",
    "########.M.............................#...............#",
    "########.MCCC...================########...............#",
    "########.M......................#......................#",
    "########.MMMMM###################......................#",
    "########...............................................#",
    "########.............................................###",
    "########.==========..................................###",
    "########.............................................###",
    "#########wwwww#####..=====...........................###",
    "######..#######......................................###",
    "#####................................................###",
    "###..................................................###",
    "###..................................................###",
    "###..................................................###",
    "###..................................................###",
    "###..................................................###",
    "###..................................................###",
    "###..................................................###",
    "###..................................................###",
    "###..................................................###",
    "###..................................................###",
    "###..................................................###",
    "###..................................................###",
    "###..................................................###",
    "###..................................................###",
    "###..................................................###",
    "###..................................................###",
    "###..................................................###",
    "###..................................................###",
    "####.................................................###",
    "####.................................................###",
    "####.................................................###",
    "####.................................................###",
    "####.................................................###",
    "####.................................................###",
    "####.................................................###",
    "####.................................................###",
    "########################################################",
    "########################################################",
    "########################################################"
  ],
  "entities": [
    {
      "type": "spawn",
      "x": 33,
      "y": 7
    },
    {
      "type": "checkpoint",
      "x": 34,
      "y": 7
    },
    {
      "type": "door",
      "x": 51,
      "y": 52,
      "to": "next"
    },
    {
      "type": "pickup",
      "x": 30,
      "y": 7,
      "item": "scrap_metal",
      "count": 1
    },
    {
      "type": "pickup",
      "x": 51,
      "y": 7,
      "item": "plank",
      "count": 1
    },
    {
      "type": "door",
      "x": 15,
      "y": 18,
      "to": "next",
      "gate": true,
      "fuseId": "A"
    },
    {
      "type": "pickup",
      "x": 37,
      "y": 16,
      "item": "cog",
      "count": 1
    },
    {
      "type": "fusebox",
      "x": 9,
      "y": 12,
      "fuseId": "A"
    },
    {
      "type": "trapdoor",
      "x": 19,
      "y": 24
    },
    {
      "type": "trapdoor",
      "x": 26,
      "y": 24
    }
  ]
}
