{
  "id": "orientation",
  "name": "First Day",
  "width": 64,
  "height": 24,
  "background": "#17131f",
  "tiles": [
    "################################################################",
    "################################################################",
    "################################################################",
    "################################################################",
    "################################################################",
    "################################################################",
    "################################........llllllll..............##",
    "################################..............................##",
    "################################..............................##",
    "################################..............................##",
    "################################..............................##",
    "################################..............................##",
    "########.......................C..............................##",
    "########.......................C..............................##",
    "########.......................C..............................##",
    "#..............................C.........................W....##",
    "#..y......y....................C.........................W.b..##",
    "#...y....y.....................C.........................W....##",
    "#..............#######################...................W.b..##",
    "#..............#######################...................W....##",
    "#.........###..#######################.TT................W....##",
    "###############################################...##############",
    "###############################################^^^##############",
    "################################################################"
  ],
  "entities": [
    {
      "type": "spawn",
      "x": 6,
      "y": 20
    },
    {
      "type": "hint",
      "x": 6,
      "y": 17,
      "text": "A / D — move · SPACE — jump"
    },
    {
      "type": "hint",
      "x": 14,
      "y": 15,
      "text": "hold SPACE to jump higher"
    },
    {
      "type": "hint",
      "x": 25,
      "y": 15,
      "text": "TAB — craft what you find"
    },
    {
      "type": "hint",
      "x": 53,
      "y": 14,
      "text": "light the way"
    },
    {
      "type": "pickup",
      "item": "plank",
      "x": 16,
      "y": 17
    },
    {
      "type": "pickup",
      "item": "cloth",
      "x": 44,
      "y": 20
    },
    {
      "type": "brazier",
      "x": 52,
      "y": 20
    },
    {
      "type": "note",
      "x": 54,
      "y": 20,
      "recipe": "recipe_torch",
      "text": "Cloth wrapped on a plank makes a torch — but it wants a flame first. The brazier never goes out. The wooden doors DO. — Subject #58. P.S. The welcome banner says it is my first day. It always says that. Light the way anyway."
    },
    {
      "type": "door",
      "x": 60,
      "y": 20,
      "to": "next"
    },
    {
      "type": "pickup",
      "item": "plank",
      "x": 56,
      "y": 20
    },
    {
      "type": "pickup",
      "x": 11,
      "y": 19,
      "item": "scrap_metal",
      "count": 1
    }
  ]
}
