{
  "id": "orientation",
  "name": "Orientation",
  "width": 44,
  "height": 24,
  "background": "#17131f",
  "tiles": [
    "############################################",
    "#..........................................#",
    "#..........................................#",
    "#..........................................#",
    "#..........................................#",
    "#..........................................#",
    "#..........................................#",
    "#..........................................#",
    "#..........................................#",
    "#..........................................#",
    "#..........................................#",
    "#..........................................#",
    "#..........................................#",
    "#..........................................#",
    "#..........................................#",
    "#..........................................#",
    "#..........................................#",
    "#...................................C......#",
    "#...................###.............C......#",
    "#.............###...###.............C......#",
    "#.............###...###.............C......#",
    "###########################...##############",
    "###########################^^^##############",
    "############################################"
  ],
  "entities": [
    {
      "type": "spawn",
      "x": 3,
      "y": 20
    },
    {
      "type": "pickup",
      "item": "scrap_metal",
      "x": 9,
      "y": 20
    },
    {
      "type": "pickup",
      "item": "plank",
      "x": 21,
      "y": 17
    },
    {
      "type": "pickup",
      "item": "scrap_metal",
      "x": 25,
      "y": 20
    },
    {
      "type": "note",
      "x": 33,
      "y": 20,
      "recipe": "recipe_hammer",
      "text": "Day 12. The walls with CRACKS can break. Metal + plank made me a hammer. The Warden watched me build it and said nothing. Unsettling. — Subject #31"
    },
    {
      "type": "door",
      "x": 41,
      "y": 20,
      "to": "next"
    }
  ]
}
