{
  "id": "storage",
  "name": "Storage",
  "width": 48,
  "height": 24,
  "background": "#151a24",
  "tiles": [
    "################################################",
    "#..............................................#",
    "#..............................................#",
    "#..............................................#",
    "#..............................................#",
    "#..............................................#",
    "#..............................................#",
    "#..............................................#",
    "#..............................................#",
    "#..............................................#",
    "#..............................................#",
    "#..............................................#",
    "#.......................========..##############",
    "#.................................##############",
    "#.................................##############",
    "#...............======............##############",
    "#.................................##############",
    "#.................................##############",
    "#.......======....................##############",
    "#.................................##############",
    "#.............................^^^^##############",
    "################################################",
    "################################################",
    "################################################"
  ],
  "entities": [
    {
      "type": "spawn",
      "x": 3,
      "y": 20
    },
    {
      "type": "pickup",
      "item": "cloth",
      "x": 5,
      "y": 20
    },
    {
      "type": "pickup",
      "item": "cloth",
      "x": 10,
      "y": 17
    },
    {
      "type": "pickup",
      "item": "rope",
      "x": 18,
      "y": 14
    },
    {
      "type": "pickup",
      "item": "plank",
      "x": 26,
      "y": 11
    },
    {
      "type": "pickup",
      "item": "rope",
      "x": 37,
      "y": 11
    },
    {
      "type": "enemy",
      "enemy": "crawler",
      "x": 16,
      "y": 20,
      "patrolMinX": 14,
      "patrolMaxX": 28
    },
    {
      "type": "checkpoint",
      "x": 40,
      "y": 11
    },
    {
      "type": "door",
      "x": 45,
      "y": 10,
      "to": "next"
    }
  ]
}
