{
  "id": "storage",
  "name": "Storage",
  "width": 48,
  "height": 24,
  "background": "#151a24",
  "tiles": [
    "################################################",
    "#.....................................##########",
    "#.....................................##########",
    "#.....................................##########",
    "#.....................................##########",
    "#.....................................##########",
    "#.....................................##########",
    "#.....................................##########",
    "#.....................................##########",
    "#.....................................##########",
    "#..............................................#",
    "#....................................fff.......#",
    "#.......................========..##############",
    "#.................................##############",
    "#.................................##############",
    "#...............======............##############",
    "#.................................##############",
    "#.................................##############",
    "#.......======....................##############",
    "#.................................##############",
    "#.........................ff......##############",
    "##################wwwww#########################",
    "################################################",
    "################################################"
  ],
  "entities": [
    {
      "type": "spawn",
      "x": 3,
      "y": 20
    },
    {
      "type": "note",
      "x": 12,
      "y": 20,
      "recipe": "recipe_bucket",
      "text": "Bend the scrap into a bowl, rope for a handle. The pools refill it forever. Fire hates it. — Subject #22"
    },
    {
      "type": "pickup",
      "item": "rope",
      "x": 9,
      "y": 17
    },
    {
      "type": "hint",
      "x": 20,
      "y": 19,
      "text": "F — scoop water · F — throw it"
    },
    {
      "type": "pickup",
      "item": "scrap_metal",
      "x": 31,
      "y": 20
    },
    {
      "type": "checkpoint",
      "x": 34,
      "y": 11
    },
    {
      "type": "door",
      "x": 45,
      "y": 11,
      "to": "next"
    }
  ]
}
