{
  "id": "the_long_run",
  "name": "The Long Run",
  "width": 110,
  "height": 24,
  "background": "#1c0e14",
  "tiles": [
    "##############################################################################################################",
    "#............................................................................................................#",
    "#............................................................................................................#",
    "#............................................................................................................#",
    "#............................................................................................................#",
    "#............................................................................................................#",
    "#............................................................................................................#",
    "#............................................................................................................#",
    "#............................................................................................................#",
    "#............................................................................................................#",
    "#............................................................................................................#",
    "#............................................................................................................#",
    "#.................................................................................GGG....^^^.GG.^^^..GG......#",
    "#...............................................................................##############################",
    "#...............................................................................##############################",
    "#...............................................................................##############################",
    "#.....................................W.........................................##############################",
    "#.....................................W.........................C...............##############################",
    "#.....................................W.........................C...............##############################",
    "#.....................................W.........................C...............##############################",
    "#.................GGGGGGG.........GGGGW.........................C...............##############################",
    "##########################...###################wwwwwwww######################################################",
    "##########################^^^#################################################################################",
    "##############################################################################################################"
  ],
  "entities": [
    {
      "type": "spawn",
      "x": 9,
      "y": 20
    },
    {
      "type": "checkpoint",
      "x": 10,
      "y": 20
    },
    {
      "type": "hint",
      "x": 14,
      "y": 15,
      "text": "RUN."
    },
    {
      "type": "pickup",
      "item": "torch_lit",
      "x": 12,
      "y": 20
    },
    {
      "type": "pickup",
      "item": "frost_vial",
      "x": 44,
      "y": 20
    },
    {
      "type": "pickup",
      "item": "hammer",
      "x": 60,
      "y": 20
    },
    {
      "type": "checkpoint",
      "x": 68,
      "y": 20
    },
    {
      "type": "pickup",
      "item": "spring",
      "x": 73,
      "y": 20
    },
    {
      "type": "hint",
      "x": 75,
      "y": 15,
      "text": "up. UP."
    },
    {
      "type": "exit",
      "x": 105,
      "y": 12
    }
  ],
  "wardenChase": {
    "speed": 118,
    "delayMs": 3000
  }
}
