{
  "id": "the_vault",
  "name": "The Vault",
  "width": 64,
  "height": 26,
  "background": "#161226",
  "tiles": [
    "################################################################",
    "#.......................V......................................#",
    "#.......................V......................................#",
    "#.......................V......................................#",
    "#.......................V......................................#",
    "#.......................V......................................#",
    "#.......................V......................................#",
    "#.......................V......................................#",
    "#.......................V......................................#",
    "#.......................V......................................#",
    "#.......................V......................................#",
    "#.......................V......................................#",
    "#.......................V......................................#",
    "#.......................V......................................#",
    "#.......................V......................................#",
    "#.......................V......................................#",
    "#.......................V.W..........................M.........#",
    "#.......................V.W..........................M.........#",
    "#.......................V.W..........................M.........#",
    "#.......................V.W..........................M...#######",
    "#.......................V.W..........................M...#######",
    "#.......................V.W..........................M.........#",
    "#.......................V.W..........................M.........#",
    "##################G######DW#################wwwwwwwwwMw#########",
    "##################GGGGGGGGG#########################www#########",
    "################################################################"
  ],
  "entities": [
    {
      "type": "spawn",
      "x": 2,
      "y": 22
    },
    {
      "type": "checkpoint",
      "x": 4,
      "y": 22
    },
    {
      "type": "note",
      "x": 40,
      "y": 22,
      "text": "The box wants charge. The water carries charge. The wood doesn't care about your hammer. Work backwards. — Subject #3"
    },
    {
      "type": "pickup",
      "item": "plank",
      "x": 6,
      "y": 22
    },
    {
      "type": "pickup",
      "item": "cloth",
      "x": 9,
      "y": 22
    },
    {
      "type": "pickup",
      "item": "cog",
      "x": 12,
      "y": 22
    },
    {
      "type": "pickup",
      "item": "scrap_metal",
      "x": 15,
      "y": 22
    },
    {
      "type": "brazier",
      "x": 21,
      "y": 22
    },
    {
      "type": "hint",
      "x": 15,
      "y": 18,
      "text": "fire finds a way. help it"
    },
    {
      "type": "checkpoint",
      "x": 42,
      "y": 22
    },
    {
      "type": "hint",
      "x": 47,
      "y": 19,
      "text": "don't be in the water when it bites"
    },
    {
      "type": "fusebox",
      "x": 53,
      "y": 15,
      "fuseId": "B"
    },
    {
      "type": "door",
      "x": 58,
      "y": 22,
      "gate": true,
      "fuseId": "B"
    },
    {
      "type": "door",
      "x": 61,
      "y": 22,
      "to": "next"
    }
  ]
}
