{
  "id": "the_gap",
  "name": "The Gap",
  "width": 40,
  "height": 28,
  "background": "#141522",
  "tiles": [
    "########################################",
    "#......................................#",
    "#......................................#",
    "#......................................#",
    "#......................................#",
    "#...............................########",
    "#...............................########",
    "#...............................########",
    "#...............................########",
    "#...............................########",
    "#......................=======..########",
    "#...............................########",
    "#...............................########",
    "#.............=======...........########",
    "#...............................########",
    "#...............................########",
    "#....=======....................########",
    "#...............................########",
    "#...............................########",
    "#...............................########",
    "#...............................########",
    "#...............................########",
    "#...............................########",
    "#...............................########",
    "#.......SS....^^^^..............########",
    "########################################",
    "########################################",
    "########################################"
  ],
  "entities": [
    {
      "type": "spawn",
      "x": 2,
      "y": 24
    },
    {
      "type": "checkpoint",
      "x": 4,
      "y": 24
    },
    {
      "type": "pickup",
      "item": "spring_coil",
      "x": 6,
      "y": 24
    },
    {
      "type": "pickup",
      "item": "spring_coil",
      "x": 8,
      "y": 22
    },
    {
      "type": "pickup",
      "item": "cloth",
      "x": 17,
      "y": 12
    },
    {
      "type": "note",
      "x": 26,
      "y": 9,
      "recipe": "recipe_spring_boots",
      "text": "The shelf CANNOT be jumped. Believe me. BELIEVE ME. Coil + cloth, strap the bounce to your feet. — Subject #45"
    },
    {
      "type": "door",
      "x": 36,
      "y": 4,
      "to": "next"
    }
  ]
}
