{
  "id": "the_yard",
  "name": "The Yard",
  "width": 72,
  "height": 24,
  "background": "#221a12",
  "tiles": [
    "########################################################################",
    "#......................................................................#",
    "#......................................................................#",
    "#......................................................................#",
    "#......................................................................#",
    "#......................................................................#",
    "#......................................................................#",
    "#......................................................................#",
    "#......................................................................#",
    "#......................................................................#",
    "#......................................................................#",
    "#......................................................................#",
    "#......................................................................#",
    "#......................................................................#",
    "#......................................................................#",
    "#......................................................................#",
    "#.........................................====.........................#",
    "#...............................====...................................#",
    "#......................................................................#",
    "#......................................................................#",
    "#.......................fff...................GGGG.....................#",
    "##################www###############...###########www###################",
    "####################################^^^#################################",
    "########################################################################"
  ],
  "entities": [
    {
      "type": "spawn",
      "x": 2,
      "y": 20
    },
    {
      "type": "checkpoint",
      "x": 3,
      "y": 20
    },
    {
      "type": "pickup",
      "item": "torch_lit",
      "x": 6,
      "y": 20
    },
    {
      "type": "pickup",
      "item": "bucket",
      "x": 9,
      "y": 20
    },
    {
      "type": "enemy",
      "enemy": "crawler",
      "x": 12,
      "y": 20,
      "patrolMinX": 10,
      "patrolMaxX": 16
    },
    {
      "type": "enemy",
      "enemy": "spotter",
      "x": 29,
      "y": 20,
      "patrolMinX": 27,
      "patrolMaxX": 33
    },
    {
      "type": "pickup",
      "item": "smoke_bomb",
      "x": 33,
      "y": 16
    },
    {
      "type": "checkpoint",
      "x": 40,
      "y": 20
    },
    {
      "type": "pickup",
      "item": "frost_vial",
      "x": 43,
      "y": 15
    },
    {
      "type": "enemy",
      "enemy": "crawler",
      "x": 56,
      "y": 20,
      "patrolMinX": 54,
      "patrolMaxX": 62
    },
    {
      "type": "enemy",
      "enemy": "spotter",
      "x": 64,
      "y": 20,
      "patrolMinX": 61,
      "patrolMaxX": 67
    },
    {
      "type": "locker",
      "x": 59,
      "y": 20
    },
    {
      "type": "pickup",
      "item": "sticky_trap",
      "x": 53,
      "y": 20
    },
    {
      "type": "door",
      "x": 70,
      "y": 20,
      "to": "next"
    }
  ]
}
