{
  "id": "vents",
  "name": "The Vents",
  "width": 52,
  "height": 24,
  "background": "#101a17",
  "tiles": [
    "####################################################",
    "#...................################...............#",
    "#...................################...............#",
    "#...................################...............#",
    "#...................################...............#",
    "#...................################...............#",
    "#...................################...............#",
    "#...................################...............#",
    "#...................################...............#",
    "#...................################...............#",
    "#...................################...............#",
    "#...................################...............#",
    "#.............................#....................#",
    "#.............................#....................#",
    "#.............................#....................#",
    "#====.......========..........#....................#",
    "#.............................#....................#",
    "#.............................#....................#",
    "#....=====....................#....................#",
    "#.............................#....................#",
    "#.............................#....................#",
    "##############wwwwwww#####W######W##################",
    "##########################WWWWWWWW##################",
    "####################################################"
  ],
  "entities": [
    {
      "type": "spawn",
      "x": 2,
      "y": 20
    },
    {
      "type": "checkpoint",
      "x": 4,
      "y": 20
    },
    {
      "type": "pickup",
      "item": "plank",
      "x": 10,
      "y": 20
    },
    {
      "type": "pickup",
      "item": "cloth",
      "x": 12,
      "y": 20
    },
    {
      "type": "brazier",
      "x": 2,
      "y": 14
    },
    {
      "type": "pickup",
      "item": "glow_mushroom",
      "x": 22,
      "y": 20
    },
    {
      "type": "pickup",
      "item": "goo_blob",
      "x": 24,
      "y": 20
    },
    {
      "type": "hint",
      "x": 26,
      "y": 17,
      "text": "the duct goes under. so would a flame"
    },
    {
      "type": "door",
      "x": 49,
      "y": 20,
      "to": "next"
    }
  ]
}
