{
  "id": "vents",
  "name": "The Vents",
  "width": 52,
  "height": 24,
  "background": "#101a17",
  "tiles": [
    "####################################################",
    "#...................################...............#",
    "#...................################...............#",
    "#...................################...............#",
    "#...................################...............#",
    "#...................################...............#",
    "#...................################...............#",
    "#...................################...............#",
    "#...................################...............#",
    "#...................################...............#",
    "#...................################...............#",
    "#...................################...............#",
    "#...................################...............#",
    "#...................################...............#",
    "#.............................#....................#",
    "#.............................#....................#",
    "#.............................#....................#",
    "#.............................#....................#",
    "#.............................#.......W............#",
    "#.............................#.......W............#",
    "#.............................#......GW............#",
    "######www#################G##########G##############",
    "##########################GGGGGGGGGGGG##############",
    "####################################################"
  ],
  "entities": [
    {
      "type": "spawn",
      "x": 2,
      "y": 20
    },
    {
      "type": "checkpoint",
      "x": 4,
      "y": 20
    },
    {
      "type": "pickup",
      "item": "plank",
      "x": 10,
      "y": 20
    },
    {
      "type": "pickup",
      "item": "cloth",
      "x": 12,
      "y": 20
    },
    {
      "type": "pickup",
      "item": "plank",
      "x": 14,
      "y": 20
    },
    {
      "type": "brazier",
      "x": 17,
      "y": 20
    },
    {
      "type": "hint",
      "x": 15,
      "y": 16,
      "text": "goo carries fire. light one end, mind the other"
    },
    {
      "type": "pickup",
      "item": "glow_mushroom",
      "x": 22,
      "y": 20
    },
    {
      "type": "pickup",
      "item": "goo_blob",
      "x": 24,
      "y": 20
    },
    {
      "type": "hint",
      "x": 26,
      "y": 17,
      "text": "the duct goes under. so would a flame"
    },
    {
      "type": "brazier",
      "x": 43,
      "y": 20
    },
    {
      "type": "pickup",
      "item": "cloth",
      "x": 45,
      "y": 20
    },
    {
      "type": "door",
      "x": 49,
      "y": 20,
      "to": "next"
    }
  ]
}
