{
  "id": "vents",
  "name": "The Vents",
  "width": 52,
  "height": 24,
  "background": "#101a17",
  "tiles": [
    "####################################################",
    "#...................################...............#",
    "#...................################...............#",
    "#...................################...............#",
    "#...................################...............#",
    "#...................################...............#",
    "#...................################...............#",
    "#...................################...............#",
    "#...................################...............#",
    "#...................################...............#",
    "#...................################...............#",
    "#...................################...............#",
    "#...................################...............#",
    "#...................################...............#",
    "#...................################...............#",
    "#..................................................#",
    "#..................................................#",
    "#.............................................###..#",
    "#.............................................###..#",
    "#.............................................######",
    "#.......................GGGGG.................######",
    "####################################################",
    "####################################################",
    "####################################################"
  ],
  "entities": [
    {
      "type": "spawn",
      "x": 2,
      "y": 20
    },
    {
      "type": "checkpoint",
      "x": 6,
      "y": 20
    },
    {
      "type": "pickup",
      "item": "goo_blob",
      "x": 10,
      "y": 20
    },
    {
      "type": "pickup",
      "item": "glow_mushroom",
      "x": 14,
      "y": 20
    },
    {
      "type": "locker",
      "x": 22,
      "y": 19
    },
    {
      "type": "pickup",
      "item": "goo_blob",
      "x": 26,
      "y": 19
    },
    {
      "type": "enemy",
      "enemy": "spotter",
      "x": 30,
      "y": 20
    },
    {
      "type": "pickup",
      "item": "glow_mushroom",
      "x": 34,
      "y": 20
    },
    {
      "type": "locker",
      "x": 38,
      "y": 19
    },
    {
      "type": "pickup",
      "item": "glow_mushroom",
      "x": 50,
      "y": 18
    },
    {
      "type": "door",
      "x": 47,
      "y": 15,
      "to": "next"
    }
  ]
}
